b,b,b,b,b,b,b,b,b,b,b,b,b
b,b,b,b,b,b,b,b,b,b,b,b,b
b,b,b,b,b,b,b,b,b,b,b,b,b
b,b,b,b,b,b,b,b,b,b,b,b,b
b,b,b,b,b,b,f1,b,b,b,b,b,b
b,b,b,f,b,b,f,b,b,b,b,b,b
b,b,b,f,b,b,f,b,b,b,b,b,b
p,b,b,f,b,b,f,b,b,b,b,b,e
f,f,f,f,f,f,f,f,f1,f1,f,f,f
