b,b,b,b,b,b,b,b,b,b,b,b,b
b,b,b,b,b,b,b,b,b,b,b,b,b
b,b,b,b,b,b,b,b,b,b,b,b,b
b,b,b,b,b,b,b,b,b,b,b,b,b
b,b,b,b,b,b,f,b,b,b,b,b,b
b,b,b,f,b,b,f,b,b,b,b,b,b
b,b,b,f,b,b,f,b,b,b,b,b,b
p,b,b,f,b,b,f,b,b,b,b,b,e
f,f,f,f,f,f,f,f,f,f,f,f,f
